*                                      *
*                                      *
*                                      *
*              *********               *
*              *********               *
*              *********               *
*                                      *
*                                      *
*S                                     *
*                                      *
*                                      *
*                                      *
**********                             *
*                                      *
*                                      *
*                                      *
*                                      *
*                                      *
*                                      *
*                                      *
*                                      *
*                                      *
*                                      *
*                                      *
*                                      *
*                                      *
*                                   GDD*
*                                   DDD*
*                                   DDD*
*                          *************
