*                                      *
*                                      *
*                                      *
*              *********               *
*              *********               *
*              *********               *
*                                      *
*                                      *
*S                                     *
*                                      *
*                                      *
*                                      *
**********                             *
*                                      *
*                                      *
*                                      *
*                                *******
*                                     **
*                                     **
*                                     **
*                                     **
*                                     **
*                                *******
*                                      *
*                                      *
*                                      *
*                                      *
*                                      *
*                                      *
*                                      *
