*                                      *
*                                      *
*                                      *
*              *********               *
*              *********               *
*              *********               *
*                                      *
*                                      *
*S                                     *
*                                      *
*                                      *
*                                      *
**********                             *
*                                      *
*                                      *
*                                      *
*                                      *
*                                      *
*                                      *
*                                      *
*                                      *
*                                      *
*                                      *
*                                      *
*                                      *
*                                      *
*                                      *
*                                      *
*                                     G*
*                          *************
