*S                                     *
*                                      *
*                                      *
***                                    *
*                                      *
*                                      *
*                                      *
*                                      *
*                                      *
*                                      *
*                                      *
*                                      *
*                                      *
*                                      *
*                                      *
*                                      *
*                                      *
*                                      *
*                                      *
*                                      *
*                                      *
*                                      *
*                                      *
*                                      *
*                                      *
*                                      *
*                                      *
*                                      *
*                                      *
*                                      *
