*                                      *
*                                      *
*    S                                 *
*                                      *
*                                      *
*    **************                    *
*                                      *
*                                      *
*                                      *
*                                      *
*             ********************     *
*                                      *
*                                      *
*                                      *
*                                      *
*    *********************             *
*                                      *
*                                      *
*                                      *
*                                      *
*           ***********************    *
*                                      *
*                                      *
*                                      *
*                  G                   *
*    ***************                   *
*    ***************                   *
*                                      *
*                                      *
*                                      *
