*                                      *
*                                      *
*                                      *
****                                   *
*                                      *
*                                      *
*      *                               *
*      *                               *
*      *                               *
*      ***********************    ******
*                                      *
*                                      *
*                                      *
*                 **********************
*                                      *
*      ********                        *
*                                      *
*                                      *
**                                     *
***                                    *
****           ********                *
*****                                  *
******                                 *
*******                                *
********             ***************   *
*********                              *
**********                             *
***********                            *
************                           *
****************************************
