TTTTTTTTTTTTTTTTTTTTTTTTTTTTTTTTT*******
TTTTTTTTTTTTTTT   W      TTTTTTT       *
TTTTTTTTTTTTTT          TTTTTTT        *
TTTTTTTTTTTTT          TTTTTT          *
TTTTTTTTTTTTT         TTTTTT           *
TTTTTTTTTTTT         TTTTTT            *
TTTTTTTTTTT         TTTTT              *
TTTTTTTTTT         TTTTT               *
TTTTTTTTT         TTTTT                *
TTTTTTTTT        TTTTT                 *
TTTTTTTT        TTTTT                  *
TTTTTTT        TTTTT                   *
TTTTTT        TTTTT                    *
TTTTT        TTTTT                     *
TTTT        TTTTT                      *
TT         TTTTT                       *
T  S       TTTT                        *
T          TT                          *
T          T                           *
T******TTTT                            *
*TTTTTTTTT                             *
*                                      *
*                                      *
*                                      *
*                                      *
*                                   GDD*
*                W                  DDD*
*                                   DDD*
*                                *******
*                                      *
