*                                      *
I                                      I
I                                      I
I                                      I
I                                      I
I                                      I
I                                      I
I                                      I
I                                      I
I                                      I
I                                      I
I                                      I
I                                      I
I                                      I
I                                      I
I                                      I
I                                      I
I                                      I
I                                      I
I                                      I
I                                      I
I                                      I
I                                      I
I                                      I
I  S                                GDDI
I                 RR                DDDI
I                 RR                DDDI
I**************************************I
IIIIIIIIIIIIIIIIIIIIIIIIIIIIIIIIIIIIIIII
IIIIIIIIIIIIIIIIIIIIIIIIIIIIIIIIIIIIIIII
