*                                      *
I                                      I
I                                      I
I                                      I
I                                      I
I                                      I
I                                      I
I                                      I
I                                      I
I                                      I
I                                      I
I                                      I
I                                      I
I                                      I
I                                      I
I                                      I
I                                      I
I                                      I
I                                      I
I                                      I
I                                      I
I                                      I
I                                      I
I                                      I
I  S                                   I
I                 RR                   I
I                 RR                  GI
I**************************************I
IIIIIIIIIIIIIIIIIIIIIIIIIIIIIIIIIIIIIIII
IIIIIIIIIIIIIIIIIIIIIIIIIIIIIIIIIIIIIIII
