*                                      *
I                                      I
I                                      I
I                                      I
I                                      I
I                                      I
I                                      I
I                                      I
I                                      I
I                                      I
I                                      I
I                                      I
I                                      I
I                                      I
I                                      I
I                                      I
I                                      I
I                                      I
I                                      I
I                                      I
I                                      I
I                                      I
I                                      I
I                                      I
I  S                                GDDI
I                 **                DDDI
I                 **                DDDI
I********************TT****************I
IIIIIIIIIIIIIIIIIIIIIIIIIIIIIIIIIIIIIIII
IIIIIIIIIIIIIIIIIIIIIIIIIIIIIIIIIIIIIIII
