*                                      *
I                                      I
I                                      I
I                                      I
I                                      I
I                                      I
I                                      I
I                                      I
I                                      I
I                                      I
I                                      I
I                                      I
I                                      I
I                                      I
I                                      I
I                                      I
I                                      I
I                                      I
I                                      I
I                                      I
I                                      I
I                                      I
I                                      I
I                 B                    I
I  S                                GDDI
I                 **                DDDI
I                 **                DDDI
I*******B************TT****************I
IIIIIIIIIIIIIIIIIIIIIIIIIIIIIIIIIIIIIIII
IIIIIIIIIIIIIIIIIIIIIIIIIIIIIIIIIIIIIIII
