*                                      *
I                                      I
I                                      I
I                                      I
I                                      I
I                                      I
I                                      I
I                                      I
I                                      I
I                                      I
I                                      I
I                                      I
I                                      I
I                                      I
I                                      I
I                                      I
I                                      I
I                                      I
I                                      I
I                                      I
I                                      I
I                                      I
I                                      I
I                                      I
I  S                                GDDI
I                 RR                DDDI
I                 RR                DDDI
I********************TT****************I
IIIIIIIIIIIIIIIIIIIIIIIIIIIIIIIIIIIIIIII
IIIIIIIIIIIIIIIIIIIIIIIIIIIIIIIIIIIIIIII
